%%%%%%%%%%%%%%%%%%%%%%%%%%%%%%%%%%%%%%%%
%   %   %. %.%.%       %     %.%.%   %4%
% % % % %%       %%  %   %%%   %.% % %2%
% % % % %. % %%%    %%%% .%..% % % % % %
% % % % %% % ..% %   %   %%%%% % % % % %
% % % %    %%%%%o%%%   %%%.% . % % % % %
% % % %% % ....  %.%%%       %   % % % %
% % % %. %%.%%%%        %.%%%%  %% % % %
% % % %%  %%%%.%        %%%%.%% .% % % %
% % % %   %       %%%.%  .... % %% % % %
% % % % % . %.%%%   %%%o%%%%%    % % % %
% % % % % %%%%%   %   % %.. % %% % % % %
% % % % % %..%. %%%%    %%% % .% % % % %
%1% % %.%   %%%   %  %%       %% % % % %
%3%   %.%.%     %       %.%.% .%   %   %
%%%%%%%%%%%%%%%%%%%%%%%%%%%%%%%%%%%%%%%%
