%%%%%%%%%%%%%%%%%%%%%%%%
%%%%%%%%%%%%%%%%%%%%%%2%
%%%o%%%%%%%%%%%.%%%%%%4%
%%%.%%%%%%%%%%%.%%%%%% %
%%%.%%%%%%%%%%%.%%%%%% %
% . .... ...   .       %
%       .   ... .... . %
% %%%%%%.%%%%%%%%%%%.%%%
% %%%%%%.%%%%%%%%%%%.%%%
%3%%%%%%.%%%%%%%%%%%o%%%
%1%%%%%%%%%%%%%%%%%%%%%%
%%%%%%%%%%%%%%%%%%%%%%%%
